Rk,,Age,G,GS,MP,FG,FGA,FG%,3P,3PA,3P%,2P,2PA,2P%,eFG%,FT,FTA,FT%,ORB,DRB,TRB,AST,STL,BLK,TOV,PF,PTS
1,D'Angelo Russell\russeda01,22,81,81,2448,659,1517,.434,234,635,.369,425,882,.482,.512,160,205,.780,53,262,315,563,100,20,253,141,1712
2,Joe Harris\harrijo01,27,76,76,2293,374,748,.500,183,386,.474,191,362,.528,.622,110,133,.827,52,239,291,181,38,17,121,182,1041
3,Jarrett Allen\allenja01,20,80,80,2096,335,568,.590,6,45,.133,329,523,.629,.595,197,278,.709,191,481,672,110,43,120,103,184,873
4,Spencer Dinwiddie\dinwisp01,25,68,4,1914,366,828,.442,124,370,.335,242,458,.528,.517,287,356,.806,26,140,166,311,40,17,152,187,1143
5,DeMarre Carroll\carrode01,32,67,8,1703,227,575,.395,106,310,.342,121,265,.457,.487,184,242,.760,68,281,349,85,31,10,73,114,744
6,Ed Davis\davised01,29,81,1,1446,186,302,.616,0,2,.000,186,300,.620,.616,100,162,.617,216,478,694,61,35,33,64,226,472
7,Rodions Kurucs\kurucro01,20,63,46,1294,202,449,.450,58,184,.315,144,265,.543,.514,72,92,.783,56,190,246,52,41,25,77,146,534
8,Rondae Hollis-Jefferson\holliro01,24,59,21,1234,200,487,.411,9,49,.184,191,438,.436,.420,118,183,.645,83,227,310,96,44,27,68,107,527
9,Jared Dudley\dudleja01,33,59,25,1220,101,239,.423,53,151,.351,48,88,.545,.533,32,46,.696,34,121,155,83,36,16,43,131,287
10,Allen Crabbe\crabbal01,26,43,20,1133,137,373,.367,98,259,.378,39,114,.342,.499,41,56,.732,16,132,148,46,23,13,46,102,413
11,Caris LeVert\leverca01,24,40,25,1063,207,483,.429,48,154,.312,159,329,.483,.478,85,123,.691,35,116,151,156,42,14,69,77,547
12,Shabazz Napier\napiesh01,27,56,2,983,169,435,.389,76,228,.333,93,207,.449,.476,115,138,.833,18,82,100,143,41,16,66,67,529
13,Treveon Graham\grahatr01,25,35,21,715,64,191,.335,38,128,.297,26,63,.413,.435,18,22,.818,23,84,107,34,13,7,17,68,184
14,Theo Pinson\pinsoth01,23,18,0,211,25,73,.342,12,46,.261,13,27,.481,.425,19,22,.864,4,32,36,21,6,0,18,15,81
15,Kenneth Faried\farieke01,29,12,0,118,25,42,.595,1,5,.200,24,37,.649,.607,10,16,.625,15,29,44,2,2,4,6,8,61
16,DÅ¾anan Musa\musadz01,19,9,0,39,9,22,.409,1,10,.100,8,12,.667,.432,0,2,.000,1,4,5,2,2,0,4,1,19
17,Mitch Creek\creekmi01,26,4,0,36,5,10,.500,0,1,.000,5,9,.556,.500,5,7,.714,5,5,10,5,1,0,0,3,15
18,Alan Williams\willial03,26,5,0,26,8,13,.615,0,1,.000,8,12,.667,.615,2,4,.500,4,15,19,3,1,0,1,2,18
19,Tahjere McCall\mccalta01,24,1,0,8,2,3,.667,0,1,.000,2,2,1.000,.667,0,1,.000,0,1,1,0,0,0,0,2,4